                                                                                                                                                                                                                                                                                                                                                                            MMMMMMMMMMMMM
                                                                                                                                                                                                                                                                                                                                                                            MMMMMMMMMMMMM
                                                                                                                                                                                                                                                                                                                                                                            MMMMMMMMMMMMM
                                                                                                                                                                   1   1                    1   1                                                                                                                                                                           MMMMMMMMMMMMM
                                                                                                                                                                 LLLLLLLLL               LLLLLLLLLL                                                                                                                                                                         MMMMMMMMMMMMM
                                                                                                                                                                                                                                                                                                                                                                            MMMMMMMMMMMMM
                                                                                                                                                                                                                                                                                                                                                                             MMMMMMMMMMMM
                                                                               MM                                                                                                                                                                                                                                                                                           MMMMMMMMMMMMM
                                                    3                          MMMMM                                                                                                                                                                                                                                                                                         MMMMMMMMMMMM
                                                    MM              LLLLL      MMMMM                                                                                                                                                                                                                                                                                        MMMMMMMMMMMMM
                                                  MMMMM                        MMMMM                  3                                     3     3                         3         3                                                                                                                                                                                     MMMMMMMMMMMMM
                                                  MMMMM                        MMMMMMM              LLLLL                                  LLL   LLL                        LL       LL                                                                                                                                                            3  1                        MMMMMMMMMM
                                                 MMMMMMM              LLLL     MMMMMMM                                                                                                                            LLLL     L     LLLL                               MKKKKKKKKKKKKKKKKKKKM                                                          LLLLLLL     1   1           MMMMMMMMMM
         7    MKKKKKM   1 1                     MMMMMMMM                       MMMMMMMMM                     1                                     1                               1                                                                               MMM                 MMM                                                                   MKKKKKKKM       * MMMMMMMMMM
BBBBBBBBBBBBBBBoooooJJJJJJJJJJJJJJJJJJJJJJJJJJJJJJJJJJJJJJJJJJJJJJJJJJJ        MMMMMMMMMJJJJJJJJJJJJJJJJJJJJJJJJJJJJJJJJJJJJJJJJJJJJJJJJJJJJJJJJJJJJJJJJJJJJJJJJJJJJJJJJJJJJJJJJJJJJJJJJJJJJJJJJJJJJJJJJJJJJJJ                           JJJJJJJJJJJJJJJJJJJJJJJJJJJJJoooooooooooooooooJJJJJJJJJJJJJJJJJJJJJJJJJMMMMMMMMMMMMMMMMMMMMMMMMMMMMMMMMMMMMMMMMMMMMMMoooooooMMMMMMMMMMMMMMMMMMMM