                                                                                                                                                                                                                                                                                                                                                                            MMMMMMMMMMMMM
                                                                                                                                                                                                                                                                                                                                                                            MMMMMMMMMMMMM
                                                                                                                                                                                                                                                                                                                                                                            MMMMMMMMMMMMM
                                                                                                                                                                   1   1                    1   1                                                                                                                                                                           MMMMMMMMMMMMM
                                                                                                                                                                 LLLLLLLLL               LLLLLLLLLL                                                                                                                                                                         MMMMMMMMMMMMM
                                                                                                                                                                                                                                                                                                                                                                            MMMMMMMMMMMMM
                                                                                                                                                                                                                                                                                                                                                                             MMMMMMMMMMMM
                                                                               MM                                                                                                                                                                                                                                                                                           MMMMMMMMMMMMM
                                                    A                          MMMMM                                                                                                                                                                                                                                                                                         MMMMMMMMMMMM
                                                    MM              LLLLL      MMMMM                                                                                                                                                                                                                                                                                        MMMMMMMMMMMMM
                                                  MMMMM                        MMMMM                  A                                     A     A                         A         A                                                                                                                                                                                     MMMMMMMMMMMMM
                                                  MMMMM                        MMMMMMM              LLLLL                                  LLL   LLL                        LL       LL                                                                                                                                                            A  1                        MMMMMMMMMM
                                                 MMMMMMM              LLLL     MMMMMMM                                                                                                                            LLLL     L     LLLL                               MAAAAAAAAAAAAAAAAAAAM                                                          LLLLLLL     1   1           MMMMMMMMMM
         7    MAAAAAM   1 1                     MMMMMMMM                       MMMMMMMMM                     1                                     1                               1                                                                               MMM                 MMM                                                                   MAAAAAAAM       * MMMMMMMMMM
BBBBBBBBBBBBBBBIIIIIJJJJJJJJJJJJJJJJJJJJJJJJJJJJJJJJJJJJJJJJJJJJJJJJJJJ        MMMMMMMMMJJJJJJJJJJJJJJJJJJJJJJJJJJJJJJJJJJJJJJJJJJJJJJJJJJJJJJJJJJJJJJJJJJJJJJJJJJJJJJJJJJJJJJJJJJJJJJJJJJJJJJJJJJJJJJJJJJJJJJ                           JJJJJJJJJJJJJJJJJJJJJJJJJJJJJIIIIIIIIIIIIIIIIIJJJJJJJJJJJJJJJJJJJJJJJJJMMMMMMMMMMMMMMMMMMMMMMMMMMMMMMMMMMMMMMMMMMMMMMIIIIIIIMMMMMMMMMMMMMMMMMMMM