# M39 f9le for t9le-b3sed g3me
# (L9nes th3t st3rt w9th '#' 3re comments)
# The t9les 3re:
#   (S93ce) Em9ty t9le

MMMMMMMMMMMMMMMMMMMMMMMMMMMMMMMMMMMMMMMMMMMMMMMMMMMMMMMMMMMMMMMMMMMMMMMMMMMMMMMMMMMMMMMMMMMMMMMMMMMMMMMMMMMM
MMMMMMMMMMMMMMMMMMMMMMMMMMMMMMMMMMMMMMMMMMMMMMMMMMMMMMMMMMMMMMMMMMMMMMMMMMMMMMMMMMMMMMMMMMMMMMMMMMMMMMMMMMMM
MMMMMMMMMMMMMMMMMMMMMMMMMMMMMMMMMMMMMMMMMMMMMMMMMMMMMMMMMMMMMMMMMMMMMMMMMMMMMMMMMMMMMMMMMMMMMMMMMMMMMMMMMMMM
MMMMMMMMMMMMMMMMMMMMMMMMMMMMMMMMMMMMMMMMMMMMMMMMMMMMMMMMMMMMMMMMMMMMMMMMMMMMMMMMMMMMMMMMMMMMMMMMMMMMMMMMMMMM
                                                                                        MMMM              MM
                                                                                        MMMM              MM
                                                      LL                                 MMM              MM
                                                                                          MM              MM
*                                                                                          M               
LLLL                                                                                       M 1           3MM
         LLLLLL                    LLLLLL                                                  MLLL      LLLLLMM
             LLLL        LLLLLL                                LL                          M        1M    MM
                                                                                              2    MMM    MM
                                                1                                                  MMM    MM
                                              MMMMMMM               MMMMM                    2    MMMM    MM
9999999999999999999999999999999999999999999999MMMMMMM999999999999999MMMMM                        MMMMM    MM
MMMMMMMMMMMMMMMMMMMMMMMMMMMMMMMMMMMMMMMMMMMMMMMMMMMMMMMMMMMMMMMMMMMMMMMMML    MMMMMMMMMMMMMMMMMMMMMMMMMMMMMM
MMMMMMMMMMMMMMMMMMMMMMMMMMMMMMMMMMMMMMMMMMM                                              MMM              MM
MMMMMMMMMMMMMMMMMMMMMMMMMMMMMMMMMMMMMMMMMMM                                               MM              MM
MMMMMMMMMMMMMMMMMMMMMMMMMMMMMMMMMMMMMMMMMMM                                                M              
MMMMMMMMMMMMMMMMMMMMMMMMMMMMMMMMMMMMMMMMMMM                              LLLL              M 1           3MM
MMMMMMMMMMMMMMMMMMMMMMMMMMMMMMMMMMMMMMMMMMM                                                MLLL      LLLLLMM
MMMMMMMMMMMMMMMMMMMMMMMMMMMMMMMMMMMMMMMMMMM                                                M       1M     MM
MMMMMMMMMMMMMMMMMMMMMMMMMMMMMMMMMMMMMMMMMMM                             MMMM                       MM     MM
MMMMMMMMMMMMMMMMMMMMMMMMMMMMMMMMMMMMMMMMMMM                             MMMMM                     MMM     MM
MMMMMMMMMMMMMMMMMMMMMMMMMMMMMMMMMMMMMMMMMMM       MMM99999MMM9999MM99999MMMMMMM                  MMMM     MM
MMMMMMMMMMMMMMMMMMMMMMMMMMMMMMMMMMMMMMMMMMMLL    LMMMMMMMMMMMMMMMMMMMMMMMMMMMMMMMMMMMMMMMMMMMMMMMMMMMMMMMMMM
MMMMMMMMMMMMMMMMMMMMMMMMMMMMMMMMMMMMMMMMMMM                                                           MMMMMM
MMMMMMMMMMMMMMMMMMMMMMMMMMMMMMMMMMMMMMMMMMM                                                             MMMM
MMMMMMMMMMMMMMMMMMMMMMMMMMMMMMMMMMMMMMMMMMM LLLLLL                                   2                    MM
MMMMMMMMMMMMMMMMMMMMMMMMMMMMMMMMMMMMMMMMMMM                                                               MM
MMMMMMMMMMMMMMMMMMMMMMMMMMMMMMMMMMMMMMMMMMM 3          1     1          1                       3         MM
MMMMMMMMMMMMMMMMMMMMMMMMMMMMMMMMMMMMMMMMMMMLLLLLLLLLLLLLLLLLLLLLLLLLLLLLLLLLLLLLLLLLLLLLLLLLLLLLLLL       MM
MMMMMMMMMMMMMMMMMMMMMMMMMMMMMMMMMMMMMMMMMMM                                                               MM
MMMMMMMMMMMMMMMMMMMMMMMMMMMMMMMMMMMMMMMMMMM                                                               MM
MMMMMMMMMMMMMMMMMMMMMMMMMMMMMMMMMMMMMMMMMMM        3      1     1        31          1  1                 MM
MMMMMMMMMMMMMMMMMMMMMMMMMMMMMMMMMMMMMMMMMMMMMMMMMMMMMMMMMMMMMMMMMMMMMMMMMMMMMMMMMMMMMMMMMMMMMMMMMMMMMMMMMMMM