# M39 f9le for t9le-b3sed g3me
# (L9nes th3t st3rt w9th '#' 3re comments)
# The t9les 3re:
#   (S93ce) Em9ty t9le

MMMMMMMMMMMMMMMMMMMMMMMMMMMMMMMMMMMMMMMMMMMMMMMMMMMMMMMMMMMMMMMMMMMMMMMMMMMMMMMMMMMMMMMMMMMMMMMMMMMMMMMMMMM
MMMMMMMMMMMMMMMMMMMMMMMMMMMMMMMMMMMMMMMMMMMMMMMMMMMMMMMMMMMMMMMMMMMMMMMMMMMMMMMMMMMMMMMMMMMMMMMMMMMMMMMMMMM
MMMMMMMMMMMMMMMMMMMMMMMMMMMMMMMMMMMMMMMMMMMMMMMMMMMMMMMMMMMMMMMMMMMMMMMMMMMMMMMMMMMMMMMMMMMMMMMMMMMMMMMMMMM
MMMMMMMMMMMMMMMMMMMMMMMMMMMMMMMMMMMMMMMMMMMMMMMMMMMMMMMMMMMMMMMMMMMMMMMMMMMMMMMMMMMMMMMMMMMMMMMMMMMMMMMMMMM
                                                                                        MMMM              M 
                                                                                        MMMM              M
                                                                                         MMM              M
                                                                                          MM              M              
 *                                                                                         M                
LLLL                                                                                       M 1           3M
         LLLLLL                    LLLLLL                                                  MLLL      LLLLLM
             LLLL        LLLLLL                                LL                          M        1M    M
                                                                                              2    MMM    M
                                                1                                                  MMM    M
                                              MMMMMMM               MMMMM                    2    MMMM    M
9999999999999999999999999999999999999999999999MMMMMMM999999999999999MMMMM                        MMMMM  o M
MMMMMMMMMMMMMMMMMMMMMMMMMMMMMMMMMMMMMMMMMMMMMMMMMMMMMMMMMMMMMMMMMMMMMMMMML    MMMMMMMMMMMMMMMMMMMMMMMMMMMMM
MMMMMMMMMMMMMMMMMMMMMMMMMMMMMMMMMMMMMMMMMMM                                              MMM              M
MMMMMMMMMMMMMMMMMMMMMMMMMMMMMMMMMMMMMMMMMMM                                               MM              M
MMMMMMMMMMMMMMMMMMMMMMMMMMMMMMMMMMMMMMMMMMM                                                M              
MMMMMMMMMMMMMMMMMMMMMMMMMMMMMMMMMMMMMMMMMMM                              LLLL              M 1           3M
MMMMMMMMMMMMMMMMMMMMMMMMMMMMMMMMMMMMMMMMMMM                                                MLLL      LLLLLM
MMMMMMMMMMMMMMMMMMMMMMMMMMMMMMMMMMMMMMMMMMM                                                M       1M     M
MMMMMMMMMMMMMMMMMMMMMMMMMMMMMMMMMMMMMMMMMMM                             MMMM                       MM     M
MMMMMMMMMMMMMMMMMMMMMMMMMMMMMMMMMMMMMMMMMMM                             MMMMM                     MMM     M
MMMMMMMMMMMMMMMMMMMMMMMMMMMMMMMMMMMMMMMMMMM       MMM99999MMM9999MM99999MMMMMMM                  MMMM   o M
MMMMMMMMMMMMMMMMMMMMMMMMMMMMMMMMMMMMMMMMMMMLL    LMMMMMMMMMMMMMMMMMMMMMMMMMMMMMMMMMMMMMMMMMMMMMMMMMMMMMMMMM
MMMMMMMMMMMMMMMMMMMMMMMMMMMMMMMMMMMMMMMMMMM                                                           MMMMM
MMMMMMMMMMMMMMMMMMMMMMMMMMMMMMMMMMMMMMMMMMM                                                             MMM
MMMMMMMMMMMMMMMMMMMMMMMMMMMMMMMMMMMMMMMMMMM LLLLLL                                   2                    M
MMMMMMMMMMMMMMMMMMMMMMMMMMMMMMMMMMMMMMMMMMM                                                               M
MMMMMMMMMMMMMMMMMMMMMMMMMMMMMMMMMMMMMMMMMMM 3          1     1          1                       3         M
MMMMMMMMMMMMMMMMMMMMMMMMMMMMMMMMMMMMMMMMMMMLLLLLLLLLLLLLLLLLLLLLLLLLLLLLLLLLLLLLLLLLLLLLLLLLLLLLLLL       D
MMMMMMMMMMMMMMMMMMMMMMMMMMMMMMMMMMMMMMMMMMM                                                               D
MMMMMMMMMMMMMMMMMMMMMMMMMMMMMMMMMMMMMMMMMMM                                                     *         D 
MMMMMMMMMMMMMMMMMMMMMMMMMMMMMMMMMMMMMMMMMMM        3      1     1        31          1  1                 D
MMMMMMMMMMMMMMMMMMMMMMMMMMMMMMMMMMMMMMMMMMMMMMMMMMMMMMMMMMMMMMMMMMMMMMMMMMMMMMMMMMMMMMMMMMMMMMMMMMMMMMMMMMM