# Map file for tile-based game
# (Lines that start with '#' are comments)
# The tiles are:
#   (Space) Empty tile
#   A..Z    Tiles A through Z
#   o       Star
#   !       Music Note
#   *       Goal
#   1       Bad Guy 1 (grub)
#   1       Bad Guy 2 (fly)

                             MMMMMMMMMMMMMMMMMMMMMMMMMMMMMMMMMMMMMMMMMMM
                             MMMMMMMMMMMMMMMMMMMMMMMMMMMMMMMMMMMMMMMMMMM
                             MMMMMMMMMMMMMMMMMMMMMMMMMMMMMMMMMMMMMMMMMMM
                             MMMMMMMMMMMMMMMMMMMMMMMMMMMMMMMMMMMMMMMMMMM
                                                    2        MMMMMMMMMMM
                                                         2   MMMMMMMMMMM
                                                        2       MMMMMMMM
                                                                MMMMMMMM
                                                                MMMMMMMM
                                     1                 1       *MMMMMMMM
                     LLLL    MMMMMMMMMMMMMMMMMMMMMMMMMMMMMMMMMMMMMMMMMMM
                              MMMMMMMMMMMMMMMMMMMMMMMMMMMMMMMMMMMMMMMMMM
              LLLLL            MMMMMMMMMMMMMMMMMMMMMMMMMMMMMMMMMMMMMMMMM
                                MMMMMMMMMMMMMMMMMMMMMMMMMMMMMMMMMMMMMMMM
                                MMMMMMMMMMMMMMMMMMMMMMMMMMMMMMMMMMMMMMMM
                      LLLLLL    MMMMMMMMMMMMMMMMMMMMMMMMMMMMMMMMMMMMMMMM
                                MMMMMMMMMMMMMMMMMMMMMMMMMMMMMMMMMMMMMMMM
             LLLLLL             MMMMMMMMMMMMMMMMMMMMMMMMMMMMMMMMMMMMMMMM
                                MMMMMMMMMMMMMMMMMMMMMMMMMMMMMMMMMMMMMMMM
   2                            MMMMMMMMMMMMMMMMMMMMMMMMMMMMMMMMMMMMMMMM
        LLLL                    MMMMMMMMMMMMMMMMMMMMMMMMMMMMMMMMMMMMMMMM
                                MMMMMMMMMMMMMMMMMMMMMMMMMMMMMMMMMMMMMMMM
                                MMMMMMMMMMMMMMMMMMMMMMMMMMMMMMMMMMMMMMMM
                 LLLLL          MMMMMMMMMMMMMMMMMMMMMMMMMMMMMMMMMMMMMMMM
                                MMMMMMMMMMMMMMMMMMMMMMMMMMMMMMMMMMMMMMMM
         LLLL                   MMMMMMMMMMMMMMMMMMMMMMMMMMMMMMMMMMMMMMMM
                                MMMMMMMMMMMMMMMMMMMMMMMMMMMMMMMMMMMMMMMM
  LLLL                          MMMMMMMMMMMMMMMMMMMMMMMMMMMMMMMMMMMMMMMM
                                MMMMMMMMMMMMMMMMMMMMMMMMMMMMMMMMMMMMMMMM
          LLLLLL                MMMMMMMMMMMMMMMMMMMMMMMMMMMMMMMMMMMMMMMM
                          2     MMMMMMMMMMMMMMMMMMMMMMMMMMMMMMMMMMMMMMMM
                     LLLL       MMMMMMMMMMMMMMMMMMMMMMMMMMMMMMMMMMMMMMMM
                              MMMMMMMMMMMMMMMMMMMMMMMMMMMMMMMMMMMMMMMMMM
              LLLL           KMMMMMMMMMMMMMMMMMMMMMMMMMMMMMMMMMMMMMMMMMM
                            KMMMMMMMMMMMMMMMMMMMMMMMMMMMMMMMMMMMMMMMMMMM
                           KKMMMMMMMMMMMMMMMMMMMMMMMMMMMMMMMMMMMMMMMMMMM
       LLLLLL           KKKMMMMMMMMMMMMMMMMMMMMMMMMMMMMMMMMMMMMMMMMMMMMM
                       KMMMMMMMMMMMMMMMMMMMMMMMMMMMMMMMMMMMMMMMMMMMMMMMM
                       MMMMMMMMMMMMMMMMMMMMMMMMMMMMMMMMMMMMMMMMMMMMMMMMM
          LLLLL                       MMMMMMMMMMMMMMMMMMMMMMMMMMMMMMMMMM
                                      MMMMMMMMMMMMMMMMMMMMMMMMMMMMMMMMMM
  LLLL                                MMMMMMMMMMMMMMMMMMMMMMMMMMMMMMMMMM
                                      MMMMMMMMMMMMMMMMMMMMMMMMMMMMMMMMMM
          LLLL      MMMMMMMMMMMMMMMMMMMMMMMMMMMMMMMMMMMMMMMMMMMMMMMMMMMM
                     MMMMMMMMMMMMMMMMMMMMMMMMMMMMMMMMMMMMMMMMMMMMMMMMMMM
                      MMMMMMMMMMMMMMMMMMMMMMMMMMMMMMMMMMMMMMMMMMMMMMMMMM
                       MMMMMMMMMMMMMMMMMMMMMMMMMMMMMMMMMMMMMMMMMMMMMMMM
                       MMMMMMMMMMMMMMMMMMMMMMMMMMMMMMMMMMMMMMMMMMMMMMMM
                       MMMMMMMMMMMMMMMMMMMMMMMMMMMMMMMMMMMMMMMMMMMMMMMM