# Map file for tile-based game
# (Lines that start with '#' are comments)
# The tiles are:
#   (Space) Empty tile
#   A..Z    Tiles A through Z
#   o       Star
#   !       Music Note
#   *       Goal
#   1       Bad Guy 1 (grub)
#   1       Bad Guy 1 (fly)

                             MMMMMMMMMMMMMMMMMMMMMMMMMMMMMMMMMMMMMMMMMMM
                             MMMMMMMMMMMMMMMMMMMMMMMMMMMMMMMMMMMMMMMMMMM
                             MMMMMMMMMMMMMMMMMMMMMMMMMMMMMMMMMMMMMMMMMMM
                             MMMMMMMMMMMMMMMMMMMMMMMMMMMMMMMMMMMMMMMMMMM
                                                             MMMMMMMMMMM
                                                             MMMMMMMMMMM
                                                             MMMMMMMMMMM
                                                                MMMMMMMM
                                                                MMMMMMMM
                                     1                 1      * MMMMMMMM
                     LLLL    MMMMMMMMMMMMMMMMMMMMMMMMMMMMMMMMMMMMMMMMMMM
                              MMMMMMMMMMMMMMMMMMMMMMMMMMMMMMMMMMMMMMMMMM
              LLLLL            MMMMMMMMMMMMMMMMMMMMMMMMMMMMMMMMMMMMMMMMM
                                MMMMMMMMMMMMMMMMMMMMMMMMMMMMMMMMMMMMMMMM
                                MMMMMMMMMMMMMMMMMMMMMMMMMMMMMMMMMMMMMMMM
                      LLLLLL    MMMMMMMMMMMMMMMMMMMMMMMMMMMMMMMMMMMMMMMM
                                MMMMMMMMMMMMMMMMMMMMMMMMMMMMMMMMMMMMMMMM
             LLLLLL             MMMMMMMMMMMMMMMMMMMMMMMMMMMMMMMMMMMMMMMM
                                MMMMMMMMMMMMMMMMMMMMMMMMMMMMMMMMMMMMMMMM
                                MMMMMMMMMMMMMMMMMMMMMMMMMMMMMMMMMMMMMMMM
        LLLL                    MMMMMMMMMMMMMMMMMMMMMMMMMMMMMMMMMMMMMMMM
                                MMMMMMMMMMMMMMMMMMMMMMMMMMMMMMMMMMMMMMMM
                                MMMMMMMMMMMMMMMMMMMMMMMMMMMMMMMMMMMMMMMM
                 LLLLL          MMMMMMMMMMMMMMMMMMMMMMMMMMMMMMMMMMMMMMMM
                                MMMMMMMMMMMMMMMMMMMMMMMMMMMMMMMMMMMMMMMM
         LLLL                   MMMMMMMMMMMMMMMMMMMMMMMMMMMMMMMMMMMMMMMM
                                MMMMMMMMMMMMMMMMMMMMMMMMMMMMMMMMMMMMMMMM
  LLLL                          MMMMMMMMMMMMMMMMMMMMMMMMMMMMMMMMMMMMMMMM
                                MMMMMMMMMMMMMMMMMMMMMMMMMMMMMMMMMMMMMMMM
          LLLLLL                MMMMMMMMMMMMMMMMMMMMMMMMMMMMMMMMMMMMMMMM
                                MMMMMMMMMMMMMMMMMMMMMMMMMMMMMMMMMMMMMMMM
                     LLLL       MMMMMMMMMMMMMMMMMMMMMMMMMMMMMMMMMMMMMMMM
                              MMMMMMMMMMMMMMMMMMMMMMMMMMMMMMMMMMMMMMMMMM
              LLLL            MMMMMMMMMMMMMMMMMMMMMMMMMMMMMMMMMMMMMMMMMM
                             MMMMMMMMMMMMMMMMMMMMMMMMMMMMMMMMMMMMMMMMMMM
                             MMMMMMMMMMMMMMMMMMMMMMMMMMMMMMMMMMMMMMMMMMM
       LLLLLL              MMMMMMMMMMMMMMMMMMMMMMMMMMMMMMMMMMMMMMMMMMMMM
                        MMMMMMMMMMMMMMMMMMMMMMMMMMMMMMMMMMMMMMMMMMMMMMMM
                       MMMMMMMMMMMMMMMMMMMMMMMMMMMMMMMMMMMMMMMMMMMMMMMMM
          LLLLL                       MMMMMMMMMMMMMMMMMMMMMMMMMMMMMMMMMM
                                      MMMMMMMMMMMMMMMMMMMMMMMMMMMMMMMMMM
  LLLL                                MMMMMMMMMMMMMMMMMMMMMMMMMMMMMMMMMM
                                      MMMMMMMMMMMMMMMMMMMMMMMMMMMMMMMMMM
          LLLL      MMMMMMMMMMMMMMMMMMMMMMMMMMMMMMMMMMMMMMMMMMMMMMMMMMMM
                     MMMMMMMMMMMMMMMMMMMMMMMMMMMMMMMMMMMMMMMMMMMMMMMMMMM
                      MMMMMMMMMMMMMMMMMMMMMMMMMMMMMMMMMMMMMMMMMMMMMMMMMM
                       MMMMMMMMMMMMMMMMMMMMMMMMMMMMMMMMMMMMMMMMMMMMMMMM
                       MMMMMMMMMMMMMMMMMMMMMMMMMMMMMMMMMMMMMMMMMMMMMMMM
                       MMMMMMMMMMMMMMMMMMMMMMMMMMMMMMMMMMMMMMMMMMMMMMMM