# Map file for tile-based game
# (Lines that start with '#' are comments)
# The tiles are:
#   (Space) Empty tile
#   A..Z    Tiles A through Z
#   o       Star
#   !       Music Note
#   *       Goal
#   1       Bad Guy 1 (grub)
#   1       Bad Guy 1 (fly)

                             MMMMMMMMMMMMMMMMMMMMMMMMMMMMMMMMMMMMM
                             MMMMMMMMMMMMMMMMMMMMMMMMMMMMMMMMMMMMM
                             MMMMMMMMMMMMMMMMMMMMMMMMMMMMMMMMMMMMM
                             MMMMMMMMMMMMMMMMMMMMMMMMMMMMMMMMMMMMM
                                                                  
                                                                  
                                                                  
                                                                  
                                                                  
                                     1                 1         *
                     LLLL    MMMMMMMMMMMMMMMMMMMMMMMMMMMMMMMMMMMMM
                              MMMMMMMMMMMMMMMMMMMMMMMMMMMMMMMMMMMM
              LLLLL            MMMMMMMMMMMMMMMMMMMMMMMMMMMMMMMMMMM
                                MMMMMMMMMMMMMMMMMMMMMMMMMMMMMMMMMM
                                MMMMMMMMMMMMMMMMMMMMMMMMMMMMMMMMMM
                      LLLLLL    MMMMMMMMMMMMMMMMMMMMMMMMMMMMMMMMMM
                                MMMMMMMMMMMMMMMMMMMMMMMMMMMMMMMMMM
             LLLLLL             MMMMMMMMMMMMMMMMMMMMMMMMMMMMMMMMMM
                                MMMMMMMMMMMMMMMMMMMMMMMMMMMMMMMMMM
                                MMMMMMMMMMMMMMMMMMMMMMMMMMMMMMMMMM
        LLLL                    MMMMMMMMMMMMMMMMMMMMMMMMMMMMMMMMMM
                                MMMMMMMMMMMMMMMMMMMMMMMMMMMMMMMMMM
                                MMMMMMMMMMMMMMMMMMMMMMMMMMMMMMMMMM
                 LLLLL          MMMMMMMMMMMMMMMMMMMMMMMMMMMMMMMMMM
                                MMMMMMMMMMMMMMMMMMMMMMMMMMMMMMMMMM
         LLLL                   MMMMMMMMMMMMMMMMMMMMMMMMMMMMMMMMMM
                                MMMMMMMMMMMMMMMMMMMMMMMMMMMMMMMMMM
  LLLL                          MMMMMMMMMMMMMMMMMMMMMMMMMMMMMMMMMM
                                MMMMMMMMMMMMMMMMMMMMMMMMMMMMMMMMMM 
          LLLLLL                MMMMMMMMMMMMMMMMMMMMMMMMMMMMMMMMMM 
                                MMMMMMMMMMMMMMMMMMMMMMMMMMMMMMMMMM
                     LLLL       MMMMMMMMMMMMMMMMMMMMMMMMMMMMMMMMMM
                              MMMMMMMMMMMMMMMMMMMMMMMMMMMMMMMMMMMM
              LLLL            MMMMMMMMMMMMMMMMMMMMMMMMMMMMMMMMMMMM
                             MMMMMMMMMMMMMMMMMMMMMMMMMMMMMMMMMMMMM
                             MMMMMMMMMMMMMMMMMMMMMMMMMMMMMMMMMMMMM
       LLLLLL              MMMMMMMMMMMMMMMMMMMMMMMMMMMMMMMMMMMMMMM
                        MMMMMMMMMMMMMMMMMMMMMMMMMMMMMMMMMMMMMMMMMM
                       MMMMMMMMMMMMMMMMMMMMMMMMMMMMMMMMMMMMMMMMMMM
          LLLLL                       MMMMMMMMMMMMMMMMMMMMMMMMMMMM
                                      MMMMMMMMMMMMMMMMMMMMMMMMMMMM
  LLLL                                MMMMMMMMMMMMMMMMMMMMMMMMMMMM
                                      MMMMMMMMMMMMMMMMMMMMMMMMMMMM
          LLLL      MMMMMMMMMMMMMMMMMMMMMMMMMMMMMMMMMMMMMMMMMMMMMM
                     MMMMMMMMMMMMMMMMMMMMMMMMMMMMMMMMMMMMMMMMMMMMM
                      MMMMMMMMMMMMMMMMMMMMMMMMMMMMMMMMMMMMMMMMMMMM        
                       MMMMMMMMMMMMMMMMMMMMMMMMMMMMMMMMMMMMMMMMMMM        
                       MMIIIIIIII
                       MMMMMMMMMM